111111111111111111111111111111
1N00C0C0NC0N0000C0000NE000C001
1001110C0011110011110011110N01
100N010NN0C0C1000CN1000C010N01
1NCC010CN011110P1111C000010N01
100N010CC00C01N00CN1000C01N001
1C0N1110001111CC111100N00100N1
10CNCN00C00C0000000N0000C000N1
10NCCCNNC0N01N0NN1111N000N0C01
10NCNCCNN001000N00001000C0N001
10NCNCNCN01NC10C0111100N00CC01
10CCNCNCC111111C0100000C00N001
10NCCCNCCC0CN10N0111100N000NC1
10C0N000NN0CN0000000N00000C001
111111111111111111111111111111