11111111111111111111111111111111
100P10100C0000N000C0001000000C01
101N1000110111010111101011111101
10C0110110000100010010000000CN01
1100000C0N0111001100111111111101
1000111111000100C0001000C0000101
10100C0001010111111110N111110101
10100111010N0100000010000C010101
10100000C0000001111111111N010101
1C1111N1111110010000001000010101
1000C000010010C00111101111110101
11111110010N00001000000010C00101
1N00C00001111110N011111010010001
1001111111C0000C00100C000001N001
10C00010001N101000101011N1111001
111110101000100C001010100010C001
100C001111111111111010100C001001
1N1111100N10C0100010101111111001
1E0000C00000100010000N10NC000001
11111111111111111111111111111111