111111111111111
1000000100000C1
1000E00C0010011
111110001111111
10000110010CN11
1010000000P0001
111111111111111