11111111111111111111111111111111
100P10100C00000000C0001000000C01
10101000110111010111101011111101
10C0110110000100010010000000C001
1100000C000111001100111111111101
1000111111000100C0001000C0000101
10100C00010101111111100111110101
1010011101010100000010000C010101
10100000C00000011111111110010101
1C111111111110010000001000010101
1000C000010010C00111101111110101
11111110010000001000000010C00101
1000C000011111100011111010010001
1001111111C0000C00100C0000010001
10C00010001010100010101111111001
111110101000100C001010100010C001
100C001111111111111010100C001001
101111100010C0100010101111111001
1E0000C000001000100000100C100001
11111111111111111111111111111111