111111111111111
10001E0100000C1
1000000C0010011
101111111111111
10000110010C011
101000000000001
111111111111111